1111111111111
10010P0E000C1
10P0011111C01
1P0010E0C0001
1111111111111
