1111111111111
1001000E000C1
10SC011111C01
1PC010E0C0S01
1111111111111
