1111111111111
1001000E0P0C1
1000S11111C01
1P0010E0C00S1
1111111111111
