1111111111111
1P01000E000C1
1P00011111C01
1P0010E0C0001
1111111111111
