1111111111111
1S01000E000C1
1000011111C01
1P0010E0C00S1
1111111111111
