1111111111111
1001000E000C1
100P011111C01
1P0010E0C0001
1111111111111
