1111111111111
1P01000E000C1
1000011111C01
100010E0C0001
1111111111111
