1111111111111
1001000E000C1
10S0011111C01
1P0010E0C0S01
1111111111111
