1111111111111
1001000E000C1
1000011111C01
1PSS10E0C0001
1111111111111
