11111111111111
10000C000C00C1
11110000011111
100C000C000C01
10000010000001
100C0010C00C01
1P000010000E01
11111111111111
