11111111111111
10000C000C00C1
111100C0011111
1S0C000C000C01
10000010S00001
100C0010C00C01
1P000010S00E01
11111111111111
