1111111
1P1P1P1
101C101
1C10101
101C101
10101C1
1010101
100E001
1111111
