11111111111111
1PC00C10000001
10111111000E01
1P0C00C1000001
1011111110C001
1P00C00C10S001
101111111000C1
10000S00000001
100000000000S1
11111111111111
